ACCESS_CONFIG	VARCHAR2(1 BYTE)	Yes
ACCESS_EOD	VARCHAR2(1 BYTE)	Yes
ACCESS_OBI	VARCHAR2(1 BYTE)	Yes
ACCESS_OCIS	VARCHAR2(1 BYTE)	Yes
ACCESS_OCM	VARCHAR2(1 BYTE)	Yes
ACCESS_ORMS	VARCHAR2(1 BYTE)	Yes
ACCESS_ORS	VARCHAR2(1 BYTE)	Yes
ACCESS_OXI	VARCHAR2(1 BYTE)	Yes
ACCESS_OXIHUB	VARCHAR2(1 BYTE)	Yes
ACCESS_PMS	VARCHAR2(1 BYTE)	Yes
ACCESS_SC	VARCHAR2(1 BYTE)	Yes
ACCESS_SCBI	VARCHAR2(1 BYTE)	Yes
ACCESS_SFA	VARCHAR2(1 BYTE)	Yes
ACCESS_UTIL	VARCHAR2(1 BYTE)	Yes
ACCOUNT_LOCKED_OUT_YN	VARCHAR2(1 BYTE)	Yes
APP_PASSWORD	VARCHAR2(40 BYTE)	No
APP_USER	VARCHAR2(40 BYTE)	No
APP_USER_DESCRIPTION	VARCHAR2(2000 BYTE)	Yes
APP_USER_ID	NUMBER	No
APP_USER_TYPE	VARCHAR2(20 BYTE)	No
APP_USER_UNIQ	VARCHAR2(60 BYTE)	No
AUTHORIZER_INACTIVE_DATE	DATE	Yes
AUTHORIZER_RATE_CODE	VARCHAR2(20 BYTE)	Yes
AUTHORIZER_YN	VARCHAR2(1 BYTE)	Yes
CHAIN_CODE	VARCHAR2(20 BYTE)	Yes
COMMENTS	VARCHAR2(2000 BYTE)	Yes
DATE_HIRED	DATE	Yes
DEFAULT_FORM	VARCHAR2(20 BYTE)	Yes
DEFAULT_LANGUAGE	VARCHAR2(20 BYTE)	Yes
DEFAULT_MFN_RESORT	VARCHAR2(20 BYTE)	Yes
DEFAULT_REPORTGROUP	VARCHAR2(80 BYTE)	Yes
DEFAULT_RESORT	VARCHAR2(20 BYTE)	Yes
DEFAULT_TERMINAL	VARCHAR2(64 BYTE)	Yes
DEF_CASHIER_ID	NUMBER	Yes
DEPT_ID	VARCHAR2(10 BYTE)	Yes
DISABLED_UNTIL	DATE	Yes
EMPLOYEE_NUMBER	VARCHAR2(20 BYTE)	Yes
EMP_EXTENSION	VARCHAR2(20 BYTE)	Yes
EMP_PAGER	VARCHAR2(80 BYTE)	Yes
EMP_STATUS	VARCHAR2(20 BYTE)	Yes
EXPIRES_ON	DATE	Yes
FORCE_PASSWORD_CHANGE_YN	VARCHAR2(1 BYTE)	Yes
FRIDAY_MAX	NUMBER	Yes
FRIDAY_MIN	NUMBER	Yes
GENERAL_FILEPATH	VARCHAR2(100 BYTE)	Yes
GRACE_LOGIN	NUMBER	Yes
HIRE_TYPE	VARCHAR2(20 BYTE)	Yes
HOURLY_RATE	NUMBER	Yes
HOURS_PER_WEEK	NUMBER	Yes
INACTIVE_DATE	DATE	Yes
INACTIVE_FROM	DATE	Yes
INACTIVE_REASON_CODE	VARCHAR2(20 BYTE)	Yes
INACTIVE_TO	DATE	Yes
INSERT_DATE	DATE	No
INSERT_USER	NUMBER	No
INTERNAL_YN	VARCHAR2(1 BYTE)	Yes
IS_SUPERUSER	VARCHAR2(1 BYTE)	Yes
LAPTOP_ID	NUMBER	Yes
LAST_LOGGED_RESORT	VARCHAR2(20 BYTE)	Yes
LAST_LOGGED_TIMESTAMP	DATE	Yes
LEAD_ADDRESS	VARCHAR2(1 BYTE)	Yes
LEAD_ADDRESS_DET	VARCHAR2(2000 BYTE)	Yes
LEAD_COMM	VARCHAR2(10 BYTE)	Yes
LOCKOUT_DATE	DATE	Yes
LOGIN_ATTEMPTS	NUMBER	Yes
LOGIN_CRO	VARCHAR2(20 BYTE)	Yes
LOGIN_DOMAIN	VARCHAR2(2000 BYTE)	Yes
MALE_FEMALE	VARCHAR2(1 BYTE)	Yes
MAX_CHECKOUT_DAYS	NUMBER	Yes
MAX_DAYS_AFTER_CO	NUMBER	Yes
MAX_USER_SESSIONS	NUMBER	Yes
MFN_USER_TYPE	VARCHAR2(1 BYTE)	Yes
MONDAY_MAX	NUMBER	Yes
MONDAY_MIN	NUMBER	Yes
NAME	VARCHAR2(80 BYTE)	Yes
ORACLE_PASSWORD	VARCHAR2(40 BYTE)	Yes
ORACLE_UID	NUMBER	Yes
ORACLE_USER	VARCHAR2(40 BYTE)	Yes
OT_MULTIPLIER	NUMBER	Yes
PASSWORD_CHANGE_DAYS	NUMBER	Yes
PASSWORD_LAST_CHANGE	DATE	Yes
PERSON_NAME_ID	NUMBER	Yes
PREVENT_ACCOUNT_LOCKOUT	VARCHAR2(1 BYTE)	Yes
PROPERTY_ACCESS_YN	VARCHAR2(1 BYTE)	Yes
RATE_TYPE	VARCHAR2(20 BYTE)	Yes
RECEIVE_BROADCAST_MSG	VARCHAR2(1 BYTE)	Yes
REHIRE_YN	VARCHAR2(1 BYTE)	Yes
SALARY_INTERVAL	VARCHAR2(1 BYTE)	Yes
SATURDAY_MAX	NUMBER	Yes
SATURDAY_MIN	NUMBER	Yes
SFA_NAME	VARCHAR2(20 BYTE)	Yes
SREP_CODE	VARCHAR2(10 BYTE)	Yes
SREP_GROUP	VARCHAR2(2000 BYTE)	Yes
SUNDAY_MAX	NUMBER	Yes
SUNDAY_MIN	NUMBER	Yes
TERMINATED_DATE	DATE	Yes
TERM_REASON	VARCHAR2(2000 BYTE)	Yes
THURSDAY_MAX	NUMBER	Yes
THURSDAY_MIN	NUMBER	Yes
TIMEZONE_REGION	VARCHAR2(80 BYTE)	Yes
TITLE	VARCHAR2(40 BYTE)	Yes
TUESDAY_MAX	NUMBER	Yes
TUESDAY_MIN	NUMBER	Yes
UPDATE_DATE	DATE	No
UPDATE_USER	NUMBER	No
USER_FILEPATH	VARCHAR2(100 BYTE)	Yes
USER_GROUP_ADMIN	VARCHAR2(1 BYTE)	Yes
USER_PBX_ID	NUMBER	Yes
WEDNESDAY_MAX	NUMBER	Yes
WEDNESDAY_MIN	NUMBER	Yes
WEEKLY_SALARY	NUMBER	Yes
WEEK_MAX	NUMBER	Yes
WEEK_MIN	NUMBER	Yes
WORK_PERMIT_EXPDATE	DATE	Yes
WORK_PERMIT_NO	VARCHAR2(80 BYTE)	Yes